1111111111
1000000001
1000000002
1000000002
1000000001
1000000001
1000000001
1000000001
1111111111
0000000000
