0000000000
1111111111
2000000002
2000000002
1111111111
0000000000
0000000000
0000000000
0000000000
0000000000
