0001111111
1111000001
2000000001
2000000001
1111001111
0001001000
0001001000
0001001000
0001001000
0001221000
