0001221000
0001001000
0001001000
0001001000
0001001000
1111001111
2000000002
2000000002
1111111111
0000000000
