0230000000
0544000000
0000000000
0000000000
0000000000
0000000000
0000000000
0000000000
0000000000
0000000000
